R 1920 1080

NO ../textures/doom/marbface.xpm
SO ../textures/doom/mountains.xpm
WE ../textures/doom/metal.xpm
EA ../textures/doom/brick.xpm
S ../textures/doom/skeleton.xpm
C 237,27,53
F 247,148,30

        111111111111111111111111
        100000000011000000000W001
        1011000201110022222000001
        100100022222222200000001
111111111011000001110000000000001
100000000011000001110111111111111
11110111111111011100000010001
11110111111111011101010010001
11000000110101011100000010001
10000000000002001100000010001
10002000000000001101010010001
1100000111010101111101111000111
11110111 1110101 101111010001
11111111 1111111 111111111111